16 16
1111111111111111
1000000010010001
1011101000110111
1000001010010011
1010101110001011
1010000000100001
1011111100111101
1010000001000101
1010000000010101
1010101101110101
1010000000000101
1010001111011101
1010101000010001
1010001000010001
1000000000000101
1111111111111111